....................
....................
....####.....####...
....#..........#....
....#..........#....
....####.....####...
....................
....####.....####...
....#..........#....
....#..........#....
....####.....####...
....................
....................
....................
....................
