....................
....................
......#######.......
......#.............
......#.............
......#######.......
....................
......#######.......
......#.............
......#.............
......#######.......
....................
....................
....................
....................
