....................
....................
.....###............
.....#..............
.....###............
........#...........
.......###..........
.........#..........
........###.........
...........#........
..........###.......
....................
....................
....................
....................
