....................
..###.......###.....
....###...###.......
......######........
......#.............
....###.......###...
..###.........###...
....................
..###.........###...
....###.......###...
......#.............
......######........
....###...###.......
..###.......###.....
....................
